6
/| |-----/
/| |T    /
/| |__T  /
/|   |T  /
///| |   /
/--| |---/
0 2